SO ./assets/purplestone.xpm
NO ./assets/wood.xpm
WE ./assets/azanane.xpm
EA ./assets/eagle.xpm
F 70, 70, 70
C 150, 150,230

1111111111111111111111111
1000000000110000000000001
1011000001110000100000001
100100000000000000000000111111111
111101111011000001110000000000001
100000000011000001110111111111111
11110111110111011100000010001
11110011111111011101010010001
110000001101010111000010000011
1000006000080000000001 10000001
1000N00010000000000100100000104
1100000111010101111101000000111
  110111 1110101 101111010001
  112111 1111111 111111111111