SO ./assets/purplestone.xpm
NO ./assets/wood.xpm
WE ./assets/azanane.xpm
EA ./assets/eagle.xpm
F 70, 70, 70
C 150, 150,230

0100011111111111111110111
1000000000110000000000001
1011900001110000100 00001
100100000004000000000000111111111
111121111011000001110000000000001
107000000011000001110111111111111
11112111110111011100000010001
11110011111111011101010010001
110000001101010111000010000011
1000006040080000000001 10000001
1000N00010000000000100100000104
1100000111010101111101000000111
  110111 1110101 101111010001
  112111 1110111 111111100111
