SO ./assets/walls/red_brick.xpm
NO ./assets/walls/wood.xpm
WE ./assets/walls/blue_bricks.xpm
EA ./assets/walls/grey_brick.xpm

F 34,34,34
C 225,30,200

        1111111111111111111111111
        1000000000110000000000001
        1011000001110000000000001
        10010000000000000000000001
111111111011000001110000000000001
100000000011000001110111121111111
11110111111111011100000010001
11110111111111011101010040001
11000000110101011100000010N01
10000000000000001100000010001
10000000000000001101010010001
1100000111010101111101111000111
11110111 1110101 101111010001
11111111 1111111 111111111111