NO ./texture/1.xpm   
WE ./texture/3.xpm      
SO    ./texture/2.xpm
EA ./texture/4.xpm

F 220,100,0
C 170,30,250

salut meec
ouais gros


        1111111111111111111111111
        1000000000110000000000001
        1011000001110000000000001
        10010000000000000000000001
111111111011000001110000000000001
100000000011000001110111111111111
11110111111111011100000010001
11110111111111011101010010001
1100000011010101 100000010001
10000000000000011100000010001
10000000000000001101010010001
11000001110101011111011110N0111
11110111 1110101 101111010001
11111111 1111111 111111111111